NO1 src/img/grasstext1.png
SO1 src/img/grasstext1.png
WE1 src/img/grasstext1.png
EA1 src/img/grasstext1.png
NO2 src/img/grasstext2.png
SO2 src/img/grasstext2.png
WE2 src/img/grasstext2.png
EA2 src/img/grasstext2.png
F 86,125,70
C 135,206,235
11111111111111111111
10000000001100001001
10000000001100001001
10000000001100000001
1111DD11111100000001
10000000000000011001
10000011100000011001
10000010D00001100001
10000011100000011001
10000010D00000000001
 1000011100000011D11
 0100000000000111001
  100000000000011D11
 100001N100000011001
10000001000000011001
11111111111111111111