NO src/img/Blue64.png
SO src/img/stonewall.png
WE src/img/stonewall.png
EA src/img/stonewall.png
F 86,125,70
C 135,206,235
11111111111111111111
10000000001100000001
10000000001100000001
11110011111100000001
10000000000000011001
10000011100000011001
10000010000001100001
10000011100000011001
10000010000000000001
10000011100000011001
10000000000000011001
1000S000000000011001
10000000000000011001
11111111111111111111