NO  src/img/tile_0001.png
WE  src/img/tile_0018.png
EA  src/img/tile_0126.png
SO  src/img/tile_0171.png
F 86,125,70
C 135,206,250
11111111111111111111
10000000001100001001
10000000001100001001
10000000001100000001
1111DD11111100000001
100000a0000000011001
10000011100000011001
10000010D00001100001
10000011100000111111
10000010D000111
10000011100000111111
10000000000000011001
1000000E00011D11
10000010100000011001
10000001000000011001
11111111111111111111